GEOID,GEO.display.label,pop,pop.white,pop.not.white,pct.white,pct.not.white
17031010201,17031010201,6450,2312,4138,0.358449612,0.641550388
17031010202,17031010202,2818,1237,1581,0.438963804,0.561036196
17031010300,17031010300,6236,3267,2969,0.523893521,0.476106479
17031010400,17031010400,5042,3341,1701,0.662633875,0.337366125
17031010503,17031010503,2290,1452,838,0.634061135,0.365938865
17031010600,17031010600,6097,3459,2638,0.567328194,0.432671806
17031010701,17031010701,3864,2125,1739,0.54994824,0.45005176
17031020100,17031020100,3965,1529,2436,0.385624212,0.614375788
17031020200,17031020200,6676,4069,2607,0.609496705,0.390503295
17031020302,17031020302,4650,3051,1599,0.656129032,0.343870968
17031020400,17031020400,4168,2266,1902,0.543666027,0.456333973
17031020602,17031020602,4340,2084,2256,0.480184332,0.519815668
17031020701,17031020701,1704,1088,616,0.638497653,0.361502347
17031020702,17031020702,7194,3618,3576,0.502919099,0.497080901
17031020801,17031020801,5458,2945,2513,0.539574936,0.460425064
17031020802,17031020802,6963,2347,4616,0.337067356,0.662932644
17031020901,17031020901,5221,1839,3382,0.352231373,0.647768627
17031020902,17031020902,4286,2095,2191,0.488800747,0.511199253
17031030101,17031030101,3893,2017,1876,0.518109427,0.481890573
17031030102,17031030102,3204,1898,1306,0.592384519,0.407615481
17031030104,17031030104,3681,2398,1283,0.651453409,0.348546591
17031030601,17031030601,4012,2179,1833,0.543120638,0.456879362
17031030701,17031030701,1549,827,722,0.533892834,0.466107166
17031030702,17031030702,1630,1006,624,0.617177914,0.382822086
17031030703,17031030703,2830,1717,1113,0.606713781,0.393286219
17031030706,17031030706,3599,2373,1226,0.659349819,0.340650181
17031030800,17031030800,4326,3333,993,0.770457698,0.229542302
17031031200,17031031200,5648,2168,3480,0.383852691,0.616147309
17031031300,17031031300,7076,3590,3486,0.507348785,0.492651215
17031031400,17031031400,5150,4066,1084,0.789514563,0.210485437
17031040100,17031040100,3985,2792,1193,0.700627353,0.299372647
17031040201,17031040201,6218,4513,1705,0.725796076,0.274203924
17031040401,17031040401,3092,2369,723,0.766170763,0.233829237
17031040402,17031040402,4468,3493,975,0.781781558,0.218218442
17031040700,17031040700,3123,2471,652,0.791226385,0.208773615
17031040800,17031040800,1514,1221,293,0.806472919,0.193527081
17031040900,17031040900,1950,1634,316,0.837948718,0.162051282
17031050100,17031050100,2290,1976,314,0.862882096,0.137117904
17031050500,17031050500,4754,4203,551,0.884097602,0.115902398
17031050700,17031050700,1418,1256,162,0.885754584,0.114245416
17031050800,17031050800,1289,1139,150,0.883630721,0.116369279
17031051200,17031051200,1516,1355,161,0.893799472,0.106200528
17031051300,17031051300,2683,2340,343,0.872158032,0.127841968
17031051400,17031051400,2077,1518,559,0.73086182,0.26913818
17031060100,17031060100,2569,2236,333,0.870377579,0.129622421
17031060200,17031060200,2111,1635,476,0.774514448,0.225485552
17031060500,17031060500,1309,1001,308,0.764705882,0.235294118
17031060800,17031060800,4837,3716,1121,0.76824478,0.23175522
17031061000,17031061000,1647,1481,166,0.899210686,0.100789314
17031061100,17031061100,1379,1276,103,0.925308194,0.074691806
17031061200,17031061200,1889,1708,181,0.904182107,0.095817893
17031061500,17031061500,1707,1562,145,0.915055653,0.084944347
17031061800,17031061800,1112,889,223,0.799460432,0.200539568
17031061901,17031061901,3433,2811,622,0.818817361,0.181182639
17031062000,17031062000,2569,2251,318,0.876216427,0.123783573
17031062100,17031062100,3436,2949,487,0.858265425,0.141734575
17031062200,17031062200,2870,2560,310,0.891986063,0.108013937
17031062300,17031062300,1513,1389,124,0.918043622,0.081956378
17031062500,17031062500,1497,1286,211,0.859051436,0.140948564
17031062600,17031062600,2226,1925,301,0.864779874,0.135220126
17031062700,17031062700,2724,2400,324,0.881057269,0.118942731
17031062900,17031062900,3976,3584,392,0.901408451,0.098591549
17031063000,17031063000,2973,2536,437,0.853010427,0.146989573
17031063200,17031063200,6345,5326,1019,0.839401103,0.160598897
17031063301,17031063301,2641,2096,545,0.793638773,0.206361227
17031063302,17031063302,3996,3380,616,0.845845846,0.154154154
17031063303,17031063303,1201,1073,128,0.893422148,0.106577852
17031070102,17031070102,2413,2063,350,0.854952341,0.145047659
17031070103,17031070103,1709,1412,297,0.82621416,0.17378584
17031070200,17031070200,3900,3327,573,0.853076923,0.146923077
17031070400,17031070400,2984,2646,338,0.886729223,0.113270777
17031070500,17031070500,2928,2647,281,0.904030055,0.095969945
17031070600,17031070600,2981,2630,351,0.882254277,0.117745723
17031071100,17031071100,2944,2590,354,0.879755435,0.120244565
17031071200,17031071200,1906,1679,227,0.880902413,0.119097587
17031071400,17031071400,4570,3888,682,0.850765864,0.149234136
17031071500,17031071500,5768,5100,668,0.884188627,0.115811373
17031071800,17031071800,2646,2051,595,0.775132275,0.224867725
17031080100,17031080100,6013,5448,565,0.90603692,0.09396308
17031080202,17031080202,3498,3112,386,0.889651229,0.110348771
17031080300,17031080300,4315,3590,725,0.83198146,0.16801854
17031081000,17031081000,7546,5672,1874,0.751656507,0.248343493
17031081100,17031081100,3640,2713,927,0.74532967,0.25467033
17031081201,17031081201,4059,3422,637,0.843064794,0.156935206
17031081202,17031081202,2995,2713,282,0.905843072,0.094156928
17031081300,17031081300,4884,4110,774,0.841523342,0.158476658
17031081401,17031081401,2279,1733,546,0.760421237,0.239578763
17031081402,17031081402,4243,3027,1216,0.713410323,0.286589677
17031081403,17031081403,6229,4384,1845,0.703804784,0.296195216
17031081500,17031081500,4379,3398,981,0.77597625,0.22402375
17031081700,17031081700,3102,2119,983,0.683107672,0.316892328
17031081800,17031081800,6866,5783,1083,0.842266239,0.157733761
17031081900,17031081900,1053,428,625,0.40645774,0.59354226
17031090100,17031090100,3405,3175,230,0.932452276,0.067547724
17031090200,17031090200,6564,6192,372,0.943327239,0.056672761
17031090300,17031090300,1372,1290,82,0.940233236,0.059766764
17031100100,17031100100,5313,4649,664,0.875023527,0.124976473
17031100200,17031100200,6749,6216,533,0.921025337,0.078974663
17031100400,17031100400,3066,2792,274,0.910632746,0.089367254
17031100500,17031100500,5779,5083,696,0.879563938,0.120436062
17031100600,17031100600,4832,4179,653,0.864859272,0.135140728
17031100700,17031100700,4826,4119,707,0.853501865,0.146498135
17031110200,17031110200,2828,2244,584,0.793493635,0.206506365
17031110300,17031110300,5161,4174,987,0.808757993,0.191242007
17031110501,17031110501,4639,3422,1217,0.737658978,0.262341022
17031110502,17031110502,3214,2450,764,0.762289981,0.237710019
17031120100,17031120100,4198,3788,410,0.902334445,0.097665555
17031120200,17031120200,4430,3863,567,0.872009029,0.127990971
17031120300,17031120300,6365,5036,1329,0.791201885,0.208798115
17031120400,17031120400,3515,2504,1011,0.712375533,0.287624467
17031130100,17031130100,5133,3393,1740,0.661016949,0.338983051
17031130200,17031130200,1412,1033,379,0.731586402,0.268413598
17031130300,17031130300,5064,2495,2569,0.492693523,0.507306477
17031140301,17031140301,2891,981,1910,0.339328952,0.660671048
17031140302,17031140302,4345,1988,2357,0.457537399,0.542462601
17031140400,17031140400,6805,4017,2788,0.590301249,0.409698751
17031140500,17031140500,3679,2220,1459,0.603424844,0.396575156
17031140800,17031140800,6825,4377,2448,0.641318681,0.358681319
17031150200,17031150200,7540,5561,1979,0.737533156,0.262466844
17031150300,17031150300,7198,5830,1368,0.809947208,0.190052792
17031150401,17031150401,4793,3818,975,0.796578343,0.203421657
17031150402,17031150402,3886,2988,898,0.76891405,0.23108595
17031150502,17031150502,4205,3237,968,0.76979786,0.23020214
17031150600,17031150600,4163,3155,1008,0.757866923,0.242133077
17031150700,17031150700,4608,3226,1382,0.700086806,0.299913194
17031150800,17031150800,5280,3622,1658,0.685984848,0.314015152
17031151001,17031151001,2819,1616,1203,0.573252927,0.426747073
17031151002,17031151002,4567,2718,1849,0.595139041,0.404860959
17031151100,17031151100,5458,3752,1706,0.687431294,0.312568706
17031151200,17031151200,3884,2910,974,0.7492276,0.2507724
17031160100,17031160100,2485,1761,724,0.708651911,0.291348089
17031160200,17031160200,3443,2587,856,0.751379611,0.248620389
17031160300,17031160300,3785,2608,1177,0.689035667,0.310964333
17031160400,17031160400,4768,3159,1609,0.662541946,0.337458054
17031160502,17031160502,3550,1879,1671,0.529295775,0.470704225
17031160800,17031160800,5148,2876,2272,0.558663559,0.441336441
17031160900,17031160900,2405,1808,597,0.751767152,0.248232848
17031161200,17031161200,2930,1681,1249,0.573720137,0.426279863
17031161300,17031161300,4117,2639,1478,0.641000729,0.358999271
17031170100,17031170100,1752,1557,195,0.88869863,0.11130137
17031170200,17031170200,3892,3201,691,0.822456321,0.177543679
17031170300,17031170300,5129,4200,929,0.818873075,0.181126925
17031170400,17031170400,3870,3331,539,0.860723514,0.139276486
17031170500,17031170500,4980,4392,588,0.881927711,0.118072289
17031170700,17031170700,2980,2609,371,0.875503356,0.124496644
17031170800,17031170800,3721,3131,590,0.841440473,0.158559527
17031170900,17031170900,1713,1311,402,0.765323993,0.234676007
17031171000,17031171000,7287,5984,1303,0.821188418,0.178811582
17031171100,17031171100,4110,3047,1063,0.74136253,0.25863747
17031180100,17031180100,6156,4382,1774,0.711825861,0.288174139
17031190100,17031190100,2488,1305,1183,0.524517685,0.475482315
17031190200,17031190200,5853,3067,2786,0.524004784,0.475995216
17031190300,17031190300,5794,3783,2011,0.65291681,0.34708319
17031190401,17031190401,4257,2427,1830,0.570119803,0.429880197
17031190402,17031190402,5458,3007,2451,0.550934408,0.449065592
17031190601,17031190601,4545,2292,2253,0.504290429,0.495709571
17031190602,17031190602,5516,2828,2688,0.512690355,0.487309645
17031190701,17031190701,2955,1235,1720,0.417935702,0.582064298
17031190702,17031190702,4869,2142,2727,0.439926063,0.560073937
17031190800,17031190800,6632,3107,3525,0.468486128,0.531513872
17031190900,17031190900,2040,991,1049,0.485784314,0.514215686
17031191000,17031191000,2559,1217,1342,0.475576397,0.524423603
17031191100,17031191100,7414,3073,4341,0.414486107,0.585513893
17031191200,17031191200,3853,1438,2415,0.373215676,0.626784324
17031191302,17031191302,5034,1879,3155,0.37326182,0.62673818
17031200100,17031200100,4354,2343,2011,0.538125861,0.461874139
17031200200,17031200200,5427,2323,3104,0.42804496,0.57195504
17031210400,17031210400,3035,1860,1175,0.612850082,0.387149918
17031210501,17031210501,3900,2436,1464,0.624615385,0.375384615
17031210502,17031210502,4486,2852,1634,0.635755684,0.364244316
17031210601,17031210601,3104,1771,1333,0.570554124,0.429445876
17031210800,17031210800,1196,637,559,0.532608696,0.467391304
17031220300,17031220300,2102,1520,582,0.723120837,0.276879163
17031220400,17031220400,2495,1871,624,0.7498998,0.2501002
17031220602,17031220602,5064,3283,1781,0.648301738,0.351698262
17031220701,17031220701,3437,1751,1686,0.509455921,0.490544079
17031220702,17031220702,4060,2077,1983,0.511576355,0.488423645
17031221000,17031221000,2923,1349,1574,0.461512145,0.538487855
17031221100,17031221100,4870,2875,1995,0.590349076,0.409650924
17031222700,17031222700,2235,1154,1081,0.516331096,0.483668904
17031230200,17031230200,2107,946,1161,0.448979592,0.551020408
17031230400,17031230400,2609,1227,1382,0.470295132,0.529704868
17031230600,17031230600,6818,1705,5113,0.250073335,0.749926665
17031230700,17031230700,6364,2041,4323,0.320710245,0.679289755
17031230900,17031230900,5399,2075,3324,0.384330432,0.615669568
17031231100,17031231100,1236,134,1102,0.108414239,0.891585761
17031231200,17031231200,6095,629,5466,0.103199344,0.896800656
17031231500,17031231500,6039,195,5844,0.032290114,0.967709886
17031240300,17031240300,1317,1165,152,0.884586181,0.115413819
17031240800,17031240800,1617,804,813,0.497217069,0.502782931
17031241300,17031241300,1857,1440,417,0.775444265,0.224555735
17031241500,17031241500,2872,2250,622,0.783426184,0.216573816
17031242200,17031242200,3590,2823,767,0.786350975,0.213649025
17031242800,17031242800,1436,1246,190,0.867688022,0.132311978
17031243000,17031243000,2204,1589,615,0.720961887,0.279038113
17031243100,17031243100,2242,1396,846,0.622658341,0.377341659
17031243200,17031243200,2170,1383,787,0.637327189,0.362672811
17031250300,17031250300,4725,512,4213,0.108359788,0.891640212
17031250400,17031250400,5887,353,5534,0.05996263,0.94003737
17031250500,17031250500,7538,3835,3703,0.508755638,0.491244362
17031250600,17031250600,4422,130,4292,0.029398462,0.970601538
17031251000,17031251000,1181,28,1153,0.023708721,0.976291279
17031251200,17031251200,4196,120,4076,0.028598665,0.971401335
17031251300,17031251300,4921,114,4807,0.023166023,0.976833977
17031251400,17031251400,3983,205,3778,0.051468742,0.948531258
17031251500,17031251500,4784,97,4687,0.02027592,0.97972408
17031251800,17031251800,5112,25,5087,0.004890454,0.995109546
17031251900,17031251900,5731,104,5627,0.01814692,0.98185308
17031252102,17031252102,6438,29,6409,0.004504505,0.995495495
17031260400,17031260400,1271,8,1263,0.006294256,0.993705744
17031260900,17031260900,1480,20,1460,0.013513514,0.986486486
17031261000,17031261000,2319,8,2311,0.003449763,0.996550237
17031271200,17031271200,1170,40,1130,0.034188034,0.965811966
17031271300,17031271300,1045,13,1032,0.012440191,0.987559809
17031271500,17031271500,1397,21,1376,0.015032212,0.984967788
17031271800,17031271800,970,19,951,0.019587629,0.980412371
17031280100,17031280100,4872,3745,1127,0.768678161,0.231321839
17031280400,17031280400,1366,120,1246,0.087847731,0.912152269
17031282800,17031282800,1691,858,833,0.507392076,0.492607924
17031291200,17031291200,2240,26,2214,0.011607143,0.988392857
17031292200,17031292200,2961,67,2894,0.022627491,0.977372509
17031300700,17031300700,5194,1876,3318,0.361185984,0.638814016
17031300900,17031300900,5050,2153,2897,0.426336634,0.573663366
17031301200,17031301200,4012,1691,2321,0.421485543,0.578514457
17031301600,17031301600,4654,2141,2513,0.460034379,0.539965621
17031301701,17031301701,4381,2199,2182,0.501940196,0.498059804
17031301801,17031301801,4005,1789,2216,0.446691635,0.553308365
17031301802,17031301802,3518,1549,1969,0.440306993,0.559693007
17031310500,17031310500,1700,712,988,0.418823529,0.581176471
17031320100,17031320100,10848,7495,3353,0.690910767,0.309089233
17031320400,17031320400,2518,1777,741,0.705718824,0.294281176
17031340300,17031340300,1786,378,1408,0.211646137,0.788353863
17031340400,17031340400,1900,330,1570,0.173684211,0.826315789
17031350100,17031350100,2144,158,1986,0.07369403,0.92630597
17031351100,17031351100,1960,19,1941,0.009693878,0.990306122
17031351400,17031351400,1437,33,1404,0.022964509,0.977035491
17031351500,17031351500,255,36,219,0.141176471,0.858823529
17031390100,17031390100,1268,51,1217,0.04022082,0.95977918
17031390600,17031390600,1866,869,997,0.465702036,0.534297964
17031400300,17031400300,1567,9,1558,0.005743459,0.994256541
17031410200,17031410200,1443,762,681,0.528066528,0.471933472
17031410500,17031410500,2557,839,1718,0.328118889,0.671881111
17031410600,17031410600,2327,1231,1096,0.529007306,0.470992694
17031410700,17031410700,2154,1261,893,0.58542247,0.41457753
17031410800,17031410800,2662,1084,1578,0.407212622,0.592787378
17031410900,17031410900,2838,1369,1469,0.482381959,0.517618041
17031411000,17031411000,3309,1763,1546,0.532789362,0.467210638
17031411100,17031411100,2132,1531,601,0.718105066,0.281894934
17031420300,17031420300,2488,865,1623,0.34766881,0.65233119
17031420400,17031420400,1329,265,1064,0.199398044,0.800601956
17031430300,17031430300,2336,20,2316,0.008561644,0.991438356
17031430700,17031430700,2210,93,2117,0.042081448,0.957918552
17031430800,17031430800,1763,19,1744,0.010777085,0.989222915
17031440101,17031440101,3746,21,3725,0.00560598,0.99439402
17031440102,17031440102,3127,11,3116,0.003517749,0.996482251
17031440300,17031440300,4757,32,4725,0.006726929,0.993273071
17031440600,17031440600,2080,7,2073,0.003365385,0.996634615
17031450300,17031450300,3615,25,3590,0.006915629,0.993084371
17031460100,17031460100,3405,358,3047,0.105139501,0.894860499
17031460200,17031460200,2385,596,1789,0.249895178,0.750104822
17031460301,17031460301,3404,457,2947,0.134253819,0.865746181
17031460500,17031460500,5789,56,5733,0.009673519,0.990326481
17031460600,17031460600,1183,106,1077,0.089602705,0.910397295
17031461000,17031461000,1496,298,1198,0.199197861,0.800802139
17031480100,17031480100,2033,11,2022,0.005410723,0.994589277
17031480300,17031480300,1468,10,1458,0.006811989,0.993188011
17031480400,17031480400,5876,58,5818,0.00987066,0.99012934
17031480500,17031480500,3206,253,2953,0.078914535,0.921085465
17031490600,17031490600,1562,2,1560,0.00128041,0.99871959
17031490700,17031490700,3085,6,3079,0.001944895,0.998055105
17031490901,17031490901,3891,21,3870,0.00539707,0.99460293
17031491300,17031491300,2886,23,2863,0.007969508,0.992030492
17031491400,17031491400,2931,16,2915,0.005458888,0.994541112
17031510100,17031510100,3530,1719,1811,0.486968839,0.513031161
17031510200,17031510200,2986,425,2561,0.142330877,0.857669123
17031520100,17031520100,2075,933,1142,0.449638554,0.550361446
17031520300,17031520300,6215,3279,2936,0.527594529,0.472405471
17031520400,17031520400,4090,2195,1895,0.536674817,0.463325183
17031520500,17031520500,4301,2905,1396,0.67542432,0.32457568
17031520600,17031520600,2544,1668,876,0.655660377,0.344339623
17031530300,17031530300,4273,25,4248,0.00585069,0.99414931
17031540102,17031540102,3109,4,3105,0.001286587,0.998713413
17031550100,17031550100,6628,4576,2052,0.690404345,0.309595655
17031550200,17031550200,2798,2116,682,0.756254467,0.243745533
17031560100,17031560100,1473,761,712,0.516632722,0.483367278
17031560200,17031560200,1721,130,1591,0.075537478,0.924462522
17031560300,17031560300,3187,2120,1067,0.665202385,0.334797615
17031560400,17031560400,1516,978,538,0.645118734,0.354881266
17031560700,17031560700,3484,2657,827,0.762629162,0.237370838
17031560800,17031560800,5411,4456,955,0.82350767,0.17649233
17031560900,17031560900,5093,4484,609,0.880424112,0.119575888
17031561000,17031561000,5161,4563,598,0.884130982,0.115869018
17031561100,17031561100,5407,4458,949,0.824486776,0.175513224
17031570200,17031570200,1943,1174,769,0.604220278,0.395779722
17031570300,17031570300,6116,3214,2902,0.525506867,0.474493133
17031570400,17031570400,1615,838,777,0.518885449,0.481114551
17031570500,17031570500,2462,1474,988,0.598700244,0.401299756
17031580200,17031580200,3515,1525,1990,0.433854908,0.566145092
17031580400,17031580400,4795,2052,2743,0.427945777,0.572054223
17031580501,17031580501,5067,2491,2576,0.491612394,0.508387606
17031580502,17031580502,5349,2472,2877,0.462142457,0.537857543
17031580600,17031580600,5531,2717,2814,0.491231242,0.508768758
17031580700,17031580700,6137,2715,3422,0.442398566,0.557601434
17031590600,17031590600,3564,1923,1641,0.53956229,0.46043771
17031590700,17031590700,3100,1824,1276,0.588387097,0.411612903
17031600400,17031600400,3891,1334,2557,0.342842457,0.657157543
17031600600,17031600600,2738,1229,1509,0.448867787,0.551132213
17031600700,17031600700,2545,1089,1456,0.427897839,0.572102161
17031600900,17031600900,3699,1706,1993,0.461205731,0.538794269
17031610400,17031610400,2213,941,1272,0.425214641,0.574785359
17031610800,17031610800,1393,1198,195,0.860014358,0.139985642
17031611000,17031611000,1098,97,1001,0.088342441,0.911657559
17031611200,17031611200,2824,919,1905,0.325424929,0.674575071
17031611600,17031611600,1609,152,1457,0.094468614,0.905531386
17031611700,17031611700,1990,226,1764,0.113567839,0.886432161
17031611800,17031611800,2139,186,1953,0.086956522,0.913043478
17031611900,17031611900,2045,153,1892,0.074816626,0.925183374
17031620100,17031620100,4289,2212,2077,0.515737934,0.484262066
17031620200,17031620200,2223,1323,900,0.5951417,0.4048583
17031620300,17031620300,6399,3877,2522,0.605875918,0.394124082
17031620400,17031620400,5198,3019,2179,0.580800308,0.419199692
17031630200,17031630200,1931,863,1068,0.446918695,0.553081305
17031630300,17031630300,5521,2347,3174,0.425104148,0.574895852
17031630500,17031630500,6364,3100,3264,0.487115022,0.512884978
17031630800,17031630800,7107,3246,3861,0.456732799,0.543267201
17031630900,17031630900,5363,2554,2809,0.476225993,0.523774007
17031640300,17031640300,6463,5055,1408,0.782144515,0.217855485
17031640400,17031640400,3190,2700,490,0.846394984,0.153605016
17031640500,17031640500,3491,2855,636,0.817817244,0.182182756
17031640600,17031640600,3912,3028,884,0.77402863,0.22597137
17031640700,17031640700,3156,2353,803,0.745564005,0.254435995
17031640800,17031640800,1716,943,773,0.5495338,0.4504662
17031650100,17031650100,4816,2683,2133,0.557101329,0.442898671
17031650200,17031650200,7320,4428,2892,0.604918033,0.395081967
17031650301,17031650301,5711,3583,2128,0.627385747,0.372614253
17031650302,17031650302,4344,2295,2049,0.528314917,0.471685083
17031650400,17031650400,6743,3269,3474,0.484799051,0.515200949
17031650500,17031650500,4421,2416,2005,0.546482696,0.453517304
17031660302,17031660302,5527,1802,3725,0.326035824,0.673964176
17031660400,17031660400,5960,2668,3292,0.447651007,0.552348993
17031660500,17031660500,5534,2444,3090,0.441633538,0.558366462
17031660600,17031660600,6333,1102,5231,0.174009158,0.825990842
17031660700,17031660700,2366,41,2325,0.017328825,0.982671175
17031660900,17031660900,4232,322,3910,0.076086957,0.923913043
17031661100,17031661100,6542,1993,4549,0.304646897,0.695353103
17031670500,17031670500,1321,22,1299,0.01665405,0.98334595
17031670600,17031670600,1650,13,1637,0.007878788,0.992121212
17031670800,17031670800,1635,5,1630,0.003058104,0.996941896
17031670900,17031670900,1351,3,1348,0.002220577,0.997779423
17031671200,17031671200,1252,8,1244,0.006389776,0.993610224
17031671300,17031671300,2688,17,2671,0.006324405,0.993675595
17031680500,17031680500,1481,12,1469,0.008102633,0.991897367
17031680900,17031680900,4019,28,3991,0.006966907,0.993033093
17031681000,17031681000,3498,22,3476,0.006289308,0.993710692
17031681400,17031681400,3247,15,3232,0.004619649,0.995380351
17031690400,17031690400,3464,17,3447,0.004907621,0.995092379
17031690500,17031690500,877,6,871,0.006841505,0.993158495
17031691000,17031691000,2492,16,2476,0.006420546,0.993579454
17031691100,17031691100,3266,28,3238,0.008573178,0.991426822
17031700200,17031700200,6609,3226,3383,0.488122258,0.511877742
17031700301,17031700301,5728,3529,2199,0.616096369,0.383903631
17031700302,17031700302,5319,3317,2002,0.623613461,0.376386539
17031700401,17031700401,5923,1367,4556,0.230795205,0.769204795
17031700501,17031700501,7125,399,6726,0.056,0.944
17031700502,17031700502,3036,269,2767,0.088603426,0.911396574
17031710300,17031710300,1414,3,1411,0.002121641,0.997878359
17031710400,17031710400,5651,29,5622,0.005131835,0.994868165
17031710800,17031710800,5338,17,5321,0.003184713,0.996815287
17031720100,17031720100,3300,2068,1232,0.626666667,0.373333333
17031720200,17031720200,4016,1597,2419,0.397659363,0.602340637
17031720300,17031720300,3723,2488,1235,0.66827827,0.33172173
17031720400,17031720400,1924,1719,205,0.893451143,0.106548857
17031720500,17031720500,2166,2051,115,0.946906741,0.053093259
17031720600,17031720600,1756,1401,355,0.797835991,0.202164009
17031720700,17031720700,3149,1061,2088,0.336932359,0.663067641
17031730100,17031730100,2424,9,2415,0.003712871,0.996287129
17031730700,17031730700,2331,13,2318,0.005577006,0.994422994
17031740100,17031740100,3048,2861,187,0.938648294,0.061351706
17031740200,17031740200,6547,5947,600,0.908354972,0.091645028
17031740400,17031740400,4785,4016,769,0.839289446,0.160710554
17031750100,17031750100,4147,35,4112,0.008439836,0.991560164
17031750200,17031750200,3227,1262,1965,0.391075302,0.608924698
17031750300,17031750300,2530,2258,272,0.892490119,0.107509881
17031750400,17031750400,3009,2026,983,0.673313393,0.326686607
17031760801,17031760801,4047,2931,1116,0.724240178,0.275759822
17031760802,17031760802,2276,2158,118,0.948154657,0.051845343
17031760803,17031760803,6236,5323,913,0.853592046,0.146407954
17031770601,17031770601,3232,2745,487,0.849319307,0.150680693
17031770602,17031770602,4956,3464,1492,0.698950767,0.301049233
17031770700,17031770700,2681,2339,342,0.872435658,0.127564342
17031770901,17031770901,4934,4383,551,0.888325902,0.111674098
17031770902,17031770902,3521,3236,285,0.919057086,0.080942914
17031800100,17031800100,2419,2336,83,0.965688301,0.034311699
17031800200,17031800200,6312,5865,447,0.92918251,0.07081749
17031800300,17031800300,3501,3329,172,0.95087118,0.04912882
17031800400,17031800400,3762,3567,195,0.948165869,0.051834131
17031800700,17031800700,5135,4625,510,0.900681597,0.099318403
17031800800,17031800800,2206,1921,285,0.87080689,0.12919311
17031801000,17031801000,4908,3922,986,0.799103504,0.200896496
17031801100,17031801100,4715,4299,416,0.911770944,0.088229056
17031801200,17031801200,3547,3390,157,0.955737243,0.044262757
17031801300,17031801300,4283,3907,376,0.912211067,0.087788933
17031801400,17031801400,2919,2366,553,0.810551559,0.189448441
17031801500,17031801500,5928,5247,681,0.885121457,0.114878543
17031801603,17031801603,3855,2338,1517,0.606485084,0.393514916
17031801605,17031801605,5599,4832,767,0.863011252,0.136988748
17031801606,17031801606,6066,5139,927,0.847181009,0.152818991
17031801607,17031801607,5287,3786,1501,0.716096085,0.283903915
17031801608,17031801608,6564,5206,1358,0.793113955,0.206886045
17031801701,17031801701,3728,3328,400,0.892703863,0.107296137
17031801800,17031801800,5619,5052,567,0.899092365,0.100907635
17031801902,17031801902,3223,2990,233,0.927707105,0.072292895
17031802002,17031802002,5071,4326,745,0.853086176,0.146913824
17031802003,17031802003,2684,2036,648,0.7585693,0.2414307
17031802100,17031802100,3573,3336,237,0.933669186,0.066330814
17031802300,17031802300,4840,3870,970,0.799586777,0.200413223
17031802402,17031802402,4821,3418,1403,0.708981539,0.291018461
17031802505,17031802505,6844,4200,2644,0.613676213,0.386323787
17031802506,17031802506,2508,1756,752,0.70015949,0.29984051
17031802609,17031802609,6699,3977,2722,0.593670697,0.406329303
17031802610,17031802610,1729,1435,294,0.829959514,0.170040486
17031802701,17031802701,6952,5077,1875,0.730293441,0.269706559
17031802702,17031802702,4498,3551,947,0.789461983,0.210538017
17031805201,17031805201,3406,2413,993,0.708455666,0.291544334
17031805202,17031805202,4028,3110,918,0.772095333,0.227904667
17031805301,17031805301,3496,2169,1327,0.620423341,0.379576659
17031805302,17031805302,3602,2398,1204,0.665741255,0.334258745
17031805401,17031805401,3841,3323,518,0.865139287,0.134860713
17031805501,17031805501,3400,3205,195,0.942647059,0.057352941
17031805600,17031805600,4511,4345,166,0.963201064,0.036798936
17031805701,17031805701,5074,4895,179,0.964722113,0.035277887
17031805702,17031805702,2015,1869,146,0.927543424,0.072456576
17031805801,17031805801,2400,2271,129,0.94625,0.05375
17031805802,17031805802,4926,4606,320,0.935038571,0.064961429
17031805901,17031805901,3834,3313,521,0.864110589,0.135889411
17031806001,17031806001,5812,3052,2760,0.52512044,0.47487956
17031806002,17031806002,7550,3985,3565,0.52781457,0.47218543
17031806003,17031806003,8109,3486,4623,0.429892712,0.570107288
17031806102,17031806102,3973,3135,838,0.789076265,0.210923735
17031806103,17031806103,5238,4196,1042,0.80106911,0.19893089
17031806104,17031806104,4206,2468,1738,0.586780789,0.413219211
17031806300,17031806300,4960,4239,721,0.854637097,0.145362903
17031806400,17031806400,2494,2107,387,0.844827586,0.155172414
17031806501,17031806501,2773,1443,1330,0.520375045,0.479624955
17031806502,17031806502,4205,3097,1108,0.736504162,0.263495838
17031806600,17031806600,3490,2778,712,0.795988539,0.204011461
17031806700,17031806700,4409,3414,995,0.774325244,0.225674756
17031806802,17031806802,3300,2078,1222,0.62969697,0.37030303
17031806900,17031806900,4713,2754,1959,0.584341184,0.415658816
17031807100,17031807100,3817,2756,1061,0.72203301,0.27796699
17031807400,17031807400,6518,3674,2844,0.563669837,0.436330163
17031807500,17031807500,3189,1833,1356,0.574788335,0.425211665
17031807700,17031807700,5933,3656,2277,0.616214394,0.383785606
17031807800,17031807800,2624,1874,750,0.714176829,0.285823171
17031807900,17031807900,4074,3005,1069,0.73760432,0.26239568
17031808001,17031808001,3646,2289,1357,0.6278113,0.3721887
17031808002,17031808002,4870,3131,1739,0.642915811,0.357084189
17031808100,17031808100,3931,3467,464,0.881963877,0.118036123
17031808301,17031808301,5625,3710,1915,0.659555556,0.340444444
17031808302,17031808302,3934,2468,1466,0.627351296,0.372648704
17031808400,17031808400,4411,2913,1498,0.660394468,0.339605532
17031808500,17031808500,4073,2864,1209,0.703167199,0.296832801
17031808800,17031808800,3955,3374,581,0.853097345,0.146902655
17031809100,17031809100,3387,3027,360,0.893711249,0.106288751
17031809200,17031809200,4611,810,3801,0.175666884,0.824333116
17031809300,17031809300,4816,3401,1415,0.706187708,0.293812292
17031809400,17031809400,5804,4084,1720,0.703652653,0.296347347
17031809500,17031809500,3670,2784,886,0.758583106,0.241416894
17031809700,17031809700,3649,1648,2001,0.451630584,0.548369416
17031809900,17031809900,2855,2398,457,0.839929947,0.160070053
17031810000,17031810000,4896,3972,924,0.81127451,0.18872549
17031810200,17031810200,5739,2343,3396,0.408259279,0.591740721
17031810301,17031810301,4002,1863,2139,0.465517241,0.534482759
17031810302,17031810302,3250,1808,1442,0.556307692,0.443692308
17031810400,17031810400,5350,5069,281,0.947476636,0.052523364
17031810501,17031810501,5049,4777,272,0.946127946,0.053872054
17031810600,17031810600,4717,3876,841,0.821708713,0.178291287
17031810701,17031810701,4916,4106,810,0.835231896,0.164768104
17031810702,17031810702,3918,3164,754,0.807554875,0.192445125
17031810800,17031810800,5324,4694,630,0.881667919,0.118332081
17031810900,17031810900,6429,5271,1158,0.819878675,0.180121325
17031811000,17031811000,4296,3867,429,0.900139665,0.099860335
17031811100,17031811100,6520,5727,793,0.878374233,0.121625767
17031811301,17031811301,4845,3246,1599,0.66996904,0.33003096
17031811302,17031811302,3778,2236,1542,0.591847538,0.408152462
17031811401,17031811401,4842,3692,1150,0.762494837,0.237505163
17031811402,17031811402,4433,3222,1211,0.726821566,0.273178434
17031811500,17031811500,5895,4709,1186,0.798812553,0.201187447
17031811600,17031811600,6213,5057,1156,0.813938516,0.186061484
17031811701,17031811701,3858,2320,1538,0.601347849,0.398652151
17031811900,17031811900,5738,4804,934,0.837225514,0.162774486
17031812000,17031812000,5434,4671,763,0.859587781,0.140412219
17031812100,17031812100,4560,2684,1876,0.588596491,0.411403509
17031812200,17031812200,3942,3115,827,0.790208016,0.209791984
17031812301,17031812301,3972,2683,1289,0.675478348,0.324521652
17031812302,17031812302,2818,2131,687,0.756210078,0.243789922
17031812400,17031812400,3491,3005,486,0.860784875,0.139215125
17031812500,17031812500,3375,1880,1495,0.557037037,0.442962963
17031812600,17031812600,3706,2029,1677,0.547490556,0.452509444
17031812700,17031812700,3216,2195,1021,0.682524876,0.317475124
17031812900,17031812900,4749,3697,1052,0.77847968,0.22152032
17031813000,17031813000,3873,2571,1302,0.663826491,0.336173509
17031813100,17031813100,4538,2531,2007,0.557734685,0.442265315
17031813301,17031813301,3502,1517,1985,0.433181039,0.566818961
17031813400,17031813400,7551,3769,3782,0.499139187,0.500860813
17031813500,17031813500,6994,3294,3700,0.470975122,0.529024878
17031813600,17031813600,5334,2853,2481,0.534870641,0.465129359
17031813701,17031813701,3780,1880,1900,0.497354497,0.502645503
17031813702,17031813702,4263,2129,2134,0.499413559,0.500586441
17031813801,17031813801,2893,1464,1429,0.506049084,0.493950916
17031814000,17031814000,4746,2494,2252,0.525495154,0.474504846
17031814100,17031814100,4544,2585,1959,0.568882042,0.431117958
17031814200,17031814200,7375,3486,3889,0.472677966,0.527322034
17031814400,17031814400,7654,4762,2892,0.622158349,0.377841651
17031814700,17031814700,5646,3109,2537,0.550655331,0.449344669
17031815000,17031815000,4131,2066,2065,0.500121036,0.499878964
17031815100,17031815100,4435,2791,1644,0.629312289,0.370687711
17031815200,17031815200,6967,4300,2667,0.61719535,0.38280465
17031815300,17031815300,3617,2634,983,0.728227813,0.271772187
17031815400,17031815400,5502,4089,1413,0.743184297,0.256815703
17031815500,17031815500,7989,5027,2962,0.629240205,0.370759795
17031815600,17031815600,4973,4163,810,0.83712045,0.16287955
17031815701,17031815701,3927,3539,388,0.901196842,0.098803158
17031815702,17031815702,5128,4682,446,0.913026521,0.086973479
17031815800,17031815800,1566,1500,66,0.957854406,0.042145594
17031815900,17031815900,4392,2266,2126,0.515938069,0.484061931
17031816000,17031816000,3330,2216,1114,0.665465465,0.334534535
17031816100,17031816100,6445,3332,3113,0.516989915,0.483010085
17031816200,17031816200,4192,2668,1524,0.636450382,0.363549618
17031816300,17031816300,4800,2832,1968,0.59,0.41
17031816401,17031816401,5142,2921,2221,0.5680669,0.4319331
17031816402,17031816402,4404,2459,1945,0.55835604,0.44164396
17031816500,17031816500,4438,2370,2068,0.534024335,0.465975665
17031816600,17031816600,4828,2196,2632,0.454846727,0.545153273
17031816700,17031816700,2809,1605,1204,0.571377714,0.428622286
17031816800,17031816800,5368,2630,2738,0.489940387,0.510059613
17031816900,17031816900,5885,1191,4694,0.202378929,0.797621071
17031817000,17031817000,5459,868,4591,0.15900348,0.84099652
17031817101,17031817101,4542,407,4135,0.089608102,0.910391898
17031817102,17031817102,3189,182,3007,0.057071182,0.942928818
17031817200,17031817200,4684,234,4450,0.049957301,0.950042699
17031817400,17031817400,4204,1768,2436,0.420551855,0.579448145
17031817500,17031817500,3623,262,3361,0.07231576,0.92768424
17031817600,17031817600,3997,338,3659,0.084563423,0.915436577
17031817700,17031817700,4929,251,4678,0.050923108,0.949076892
17031817900,17031817900,5632,913,4719,0.162109375,0.837890625
17031818000,17031818000,4234,1848,2386,0.436466698,0.563533302
17031818200,17031818200,4702,2869,1833,0.610165887,0.389834113
17031818300,17031818300,5826,2050,3776,0.351870923,0.648129077
17031818401,17031818401,3634,2140,1494,0.588882774,0.411117226
17031818402,17031818402,3051,2242,809,0.734841036,0.265158964
17031818500,17031818500,5682,4774,908,0.840197114,0.159802886
17031818900,17031818900,4299,3780,519,0.87927425,0.12072575
17031819000,17031819000,5117,4944,173,0.966191128,0.033808872
17031819100,17031819100,4552,3351,1201,0.73615993,0.26384007
17031819300,17031819300,2693,2396,297,0.889714074,0.110285926
17031819400,17031819400,5538,4577,961,0.82647165,0.17352835
17031819500,17031819500,3212,2317,895,0.72135741,0.27864259
17031819600,17031819600,4010,3829,181,0.954862843,0.045137157
17031819700,17031819700,5917,5693,224,0.962142978,0.037857022
17031819801,17031819801,5278,5124,154,0.970822281,0.029177719
17031819802,17031819802,2678,2586,92,0.965646004,0.034353996
17031820101,17031820101,6937,6426,511,0.926337033,0.073662967
17031820103,17031820103,4016,3533,483,0.879731076,0.120268924
17031820104,17031820104,4165,3656,509,0.877791116,0.122208884
17031820201,17031820201,7827,6990,837,0.893062476,0.106937524
17031820202,17031820202,3536,2750,786,0.777714932,0.222285068
17031820400,17031820400,5701,2827,2874,0.495877916,0.504122084
17031820501,17031820501,6115,5267,848,0.861324612,0.138675388
17031820502,17031820502,5150,4289,861,0.832815534,0.167184466
17031820603,17031820603,5254,4492,762,0.854967644,0.145032356
17031820604,17031820604,3839,3372,467,0.878353738,0.121646262
17031820605,17031820605,4604,1613,2991,0.350347524,0.649652476
17031820700,17031820700,6786,4601,2185,0.678013557,0.321986443
17031820800,17031820800,3626,2721,905,0.750413679,0.249586321
17031820901,17031820901,5686,4634,1052,0.814984172,0.185015828
17031820902,17031820902,5017,3822,1195,0.761809847,0.238190153
17031821002,17031821002,5593,4822,771,0.862149115,0.137850885
17031821101,17031821101,4784,3853,931,0.805392977,0.194607023
17031821102,17031821102,4047,3134,913,0.774400791,0.225599209
17031821200,17031821200,6003,1867,4136,0.311011161,0.688988839
17031821300,17031821300,5519,1976,3543,0.358035876,0.641964124
17031821600,17031821600,4393,2301,2092,0.523787844,0.476212156
17031821700,17031821700,4889,4139,750,0.846594396,0.153405604
17031821800,17031821800,5337,4069,1268,0.762413341,0.237586659
17031821900,17031821900,5233,4206,1027,0.803745461,0.196254539
17031822101,17031822101,4480,3839,641,0.856919643,0.143080357
17031822102,17031822102,4414,3256,1158,0.737652923,0.262347077
17031822200,17031822200,3703,3265,438,0.881717526,0.118282474
17031822301,17031822301,3836,3386,450,0.882690302,0.117309698
17031822302,17031822302,4484,3711,773,0.827609277,0.172390723
17031822400,17031822400,6226,5399,827,0.867169933,0.132830067
17031822500,17031822500,4455,3856,599,0.865544332,0.134455668
17031822601,17031822601,4470,4048,422,0.905592841,0.094407159
17031822602,17031822602,7061,6014,1047,0.851720719,0.148279281
17031822701,17031822701,4181,3286,895,0.785936379,0.214063621
17031822702,17031822702,3745,3091,654,0.825367156,0.174632844
17031822801,17031822801,3345,2895,450,0.865470852,0.134529148
17031822802,17031822802,3616,3348,268,0.925884956,0.074115044
17031822900,17031822900,2042,1763,279,0.863369246,0.136630754
17031823001,17031823001,6450,5174,1276,0.802170543,0.197829457
17031823101,17031823101,4412,4014,398,0.909791478,0.090208522
17031823102,17031823102,3641,3288,353,0.903048613,0.096951387
17031823200,17031823200,4877,4033,844,0.826942793,0.173057207
17031823302,17031823302,5794,3257,2537,0.562133241,0.437866759
17031823303,17031823303,4519,3464,1055,0.76654127,0.23345873
17031823304,17031823304,5927,4064,1863,0.685675721,0.314324279
17031823400,17031823400,5052,2343,2709,0.463776722,0.536223278
17031823500,17031823500,4545,2707,1838,0.59559956,0.40440044
17031823602,17031823602,6267,5823,444,0.929152705,0.070847295
17031823605,17031823605,4547,4073,474,0.895755443,0.104244557
17031823703,17031823703,7940,6782,1158,0.854156171,0.145843829
17031823705,17031823705,4618,4071,547,0.881550455,0.118449545
17031823801,17031823801,5716,5355,361,0.936843947,0.063156053
17031823803,17031823803,6760,6243,517,0.92352071,0.07647929
17031823901,17031823901,3519,3150,369,0.895140665,0.104859335
17031823903,17031823903,4707,4442,265,0.943700871,0.056299129
17031823904,17031823904,4016,3829,187,0.953436255,0.046563745
17031824105,17031824105,6845,6381,464,0.932213294,0.067786706
17031824107,17031824107,6493,5922,571,0.912059141,0.087940859
17031824108,17031824108,8063,6644,1419,0.824010914,0.175989086
17031824113,17031824113,6562,5934,628,0.90429747,0.09570253
17031824114,17031824114,4709,4234,475,0.899129327,0.100870673
17031824115,17031824115,3920,3441,479,0.877806122,0.122193878
17031824117,17031824117,9868,9000,868,0.912038914,0.087961086
17031824119,17031824119,5675,5164,511,0.909955947,0.090044053
17031824120,17031824120,8680,7820,860,0.900921659,0.099078341
17031824121,17031824121,3174,2940,234,0.926275992,0.073724008
17031824122,17031824122,6423,5893,530,0.917484042,0.082515958
17031824300,17031824300,4814,316,4498,0.065641878,0.934358122
17031824400,17031824400,2317,1167,1150,0.503668537,0.496331463
17031824503,17031824503,6740,6135,605,0.910237389,0.089762611
17031824505,17031824505,6869,5848,1021,0.851361188,0.148638812
17031824506,17031824506,7617,6929,688,0.909675725,0.090324275
17031824507,17031824507,4214,3787,427,0.898671096,0.101328904
17031824601,17031824601,4394,3932,462,0.894856623,0.105143377
17031824602,17031824602,6545,5491,1054,0.838961039,0.161038961
17031824701,17031824701,3962,2904,1058,0.73296315,0.26703685
17031824702,17031824702,5607,3680,1927,0.656322454,0.343677546
17031824800,17031824800,7756,3817,3939,0.492135121,0.507864879
17031824900,17031824900,3079,748,2331,0.242936018,0.757063982
17031825200,17031825200,2009,1361,648,0.677451468,0.322548532
17031825302,17031825302,6277,5186,1091,0.826190856,0.173809144
17031825304,17031825304,4056,3592,464,0.885601578,0.114398422
17031825400,17031825400,5419,4898,521,0.9038568,0.0961432
17031825501,17031825501,5583,659,4924,0.118036898,0.881963102
17031825503,17031825503,6608,1249,5359,0.189013317,0.810986683
17031825504,17031825504,3734,259,3475,0.069362614,0.930637386
17031825600,17031825600,5627,868,4759,0.154256264,0.845743736
17031825700,17031825700,4206,1096,3110,0.260580124,0.739419876
17031825802,17031825802,5850,591,5259,0.101025641,0.898974359
17031825803,17031825803,5811,776,5035,0.133539838,0.866460162
17031825900,17031825900,3374,880,2494,0.26081802,0.73918198
17031826100,17031826100,6414,1934,4480,0.301527908,0.698472092
17031826201,17031826201,3596,510,3086,0.141824249,0.858175751
17031826202,17031826202,5873,1561,4312,0.26579261,0.73420739
17031826301,17031826301,3956,493,3463,0.124620829,0.875379171
17031826303,17031826303,4162,290,3872,0.069678039,0.930321961
17031826304,17031826304,3203,173,3030,0.054011864,0.945988136
17031826401,17031826401,4072,182,3890,0.044695481,0.955304519
17031826600,17031826600,5540,291,5249,0.052527076,0.947472924
17031826800,17031826800,5436,1668,3768,0.306843267,0.693156733
17031826901,17031826901,1894,57,1837,0.030095037,0.969904963
17031827100,17031827100,2716,78,2638,0.028718704,0.971281296
17031827200,17031827200,4140,486,3654,0.117391304,0.882608696
17031827500,17031827500,5382,999,4383,0.185618729,0.814381271
17031827801,17031827801,4998,1695,3303,0.339135654,0.660864346
17031827802,17031827802,3385,518,2867,0.153028065,0.846971935
17031827804,17031827804,3308,607,2701,0.183494559,0.816505441
17031827901,17031827901,2605,328,2277,0.125911708,0.874088292
17031827902,17031827902,4524,1866,2658,0.412466844,0.587533156
17031828000,17031828000,5147,3208,1939,0.623275695,0.376724305
17031828100,17031828100,4844,3780,1064,0.780346821,0.219653179
17031828201,17031828201,4290,2357,1933,0.549417249,0.450582751
17031828202,17031828202,4585,2511,2074,0.547655398,0.452344602
17031828300,17031828300,3264,2206,1058,0.675857843,0.324142157
17031828401,17031828401,3644,2703,941,0.741767289,0.258232711
17031828402,17031828402,3843,2002,1841,0.520947177,0.479052823
17031830500,17031830500,4660,3023,1637,0.648712446,0.351287554
17031830600,17031830600,5005,2499,2506,0.499300699,0.500699301
17031831100,17031831100,7453,4293,3160,0.576009661,0.423990339
17031831300,17031831300,1280,215,1065,0.16796875,0.83203125
17031831400,17031831400,2964,501,2463,0.16902834,0.83097166
17031831500,17031831500,4079,2364,1715,0.579553812,0.420446188
17031831700,17031831700,2075,1302,773,0.62746988,0.37253012
17031831900,17031831900,2717,2490,227,0.916451969,0.083548031
17031832000,17031832000,1798,1597,201,0.888209121,0.111790879
17031832100,17031832100,3297,2343,954,0.710646042,0.289353958
17031832500,17031832500,3606,3023,583,0.838325014,0.161674986
17031832600,17031832600,3727,3420,307,0.917628119,0.082371881
17031832900,17031832900,2212,1471,741,0.665009042,0.334990958
17031833100,17031833100,6895,4751,2144,0.689050036,0.310949964
17031833900,17031833900,2714,621,2093,0.228813559,0.771186441
17031834200,17031834200,4944,41,4903,0.00829288,0.99170712
17031834400,17031834400,3772,185,3587,0.049045599,0.950954401
17031834600,17031834600,3778,35,3743,0.009264161,0.990735839
17031834800,17031834800,1953,8,1945,0.004096262,0.995903738
17031835000,17031835000,5778,891,4887,0.154205607,0.845794393
17031835100,17031835100,5369,2123,3246,0.395418141,0.604581859
17031835200,17031835200,2060,1404,656,0.681553398,0.318446602
17031836000,17031836000,2177,60,2117,0.027560864,0.972439136
17031836200,17031836200,1529,1019,510,0.666448659,0.333551341
17031836800,17031836800,2661,119,2542,0.04472003,0.95527997
17031838000,17031838000,2561,454,2107,0.177274502,0.822725498
17031838300,17031838300,1631,480,1151,0.294297977,0.705702023
17031838600,17031838600,1598,74,1524,0.046307885,0.953692115
17031838700,17031838700,4484,54,4430,0.012042819,0.987957181
17031839000,17031839000,7311,4989,2322,0.682396389,0.317603611
17031839100,17031839100,4350,2737,1613,0.629195402,0.370804598
17031839200,17031839200,2545,269,2276,0.105697446,0.894302554
17031839700,17031839700,4326,2440,1886,0.564031438,0.435968562
17031839800,17031839800,2730,1503,1227,0.550549451,0.449450549
17031839900,17031839900,4080,2763,1317,0.677205882,0.322794118
17031840000,17031840000,2695,1435,1260,0.532467532,0.467532468
17031840100,17031840100,2935,886,2049,0.301873935,0.698126065
17031840300,17031840300,3950,1710,2240,0.432911392,0.567088608
17031840700,17031840700,4249,1707,2542,0.401741586,0.598258414
17031840800,17031840800,3716,1680,2036,0.452099031,0.547900969
17031841100,17031841100,7254,401,6853,0.055279846,0.944720154
17031841400,17031841400,1559,53,1506,0.033996151,0.966003849
17031841700,17031841700,1442,248,1194,0.171983356,0.828016644
17031841800,17031841800,2505,37,2468,0.014770459,0.985229541
17031841900,17031841900,4865,2601,2264,0.534635149,0.465364851
17031842000,17031842000,2744,1059,1685,0.385932945,0.614067055
17031842200,17031842200,2603,1292,1311,0.496350365,0.503649635
17031842400,17031842400,3304,31,3273,0.009382567,0.990617433
17031842600,17031842600,4133,2675,1458,0.647229615,0.352770385
17031842800,17031842800,7498,3642,3856,0.485729528,0.514270472
17031842900,17031842900,2341,343,1998,0.146518582,0.853481418
17031843100,17031843100,1892,111,1781,0.058668076,0.941331924
17031843200,17031843200,2780,1387,1393,0.498920863,0.501079137
17031843500,17031843500,11309,3188,8121,0.281899372,0.718100628
17031843700,17031843700,2117,1656,461,0.782239017,0.217760983
17031843800,17031843800,2110,616,1494,0.291943128,0.708056872
17031843900,17031843900,3533,129,3404,0.036512879,0.963487121
17097864522,17097864522,4705,4356,349,0.925823592,0.074176408
17097864801,17097864801,5536,4872,664,0.880057803,0.119942197
17097864802,17097864802,2661,2486,175,0.93423525,0.06576475
17097864901,17097864901,4294,4103,191,0.955519329,0.044480671
17097864903,17097864903,4829,4488,341,0.929384966,0.070615034
17097864904,17097864904,2404,2216,188,0.921797005,0.078202995
17097865400,17097865400,4232,3605,627,0.8518431,0.1481569
17097865502,17097865502,2420,2262,158,0.934710744,0.065289256
17097865600,17097865600,3525,3381,144,0.959148936,0.040851064
17097865700,17097865700,5781,5380,401,0.930634838,0.069365162
17097865801,17097865801,3084,2840,244,0.920881971,0.079118029
17097865802,17097865802,3034,2888,146,0.951878708,0.048121292
17031010100,17031010100,4854,1810,3044,0.37288834,0.62711166
17031010501,17031010501,4091,2018,2073,0.493277927,0.506722073
17031010502,17031010502,3101,1820,1281,0.586907449,0.413092551
17031010702,17031010702,5143,2381,2762,0.462959362,0.537040638
17031020301,17031020301,4750,3965,785,0.834736842,0.165263158
17031020500,17031020500,6214,2167,4047,0.348728677,0.651271323
17031020601,17031020601,6353,3908,2445,0.615142452,0.384857548
17031030103,17031030103,1928,1150,778,0.596473029,0.403526971
17031030200,17031030200,5369,3918,1451,0.729744831,0.270255169
17031030300,17031030300,3322,1716,1606,0.516556291,0.483443709
17031030400,17031030400,2684,1818,866,0.677347243,0.322652757
17031030500,17031030500,6395,4386,2009,0.685848319,0.314151681
17031030603,17031030603,2095,1031,1064,0.492124105,0.507875895
17031030604,17031030604,2976,1592,1384,0.534946237,0.465053763
17031030900,17031030900,3028,2216,812,0.731836196,0.268163804
17031031000,17031031000,3656,2674,982,0.731400438,0.268599562
17031031100,17031031100,4402,3053,1349,0.693548387,0.306451613
17031031501,17031031501,4083,1593,2490,0.390154298,0.609845702
17031031502,17031031502,4354,1571,2783,0.360817639,0.639182361
17031031700,17031031700,6570,3811,2759,0.580060883,0.419939117
17031031800,17031031800,1820,1371,449,0.753296703,0.246703297
17031031900,17031031900,2304,1793,511,0.778211806,0.221788194
17031032100,17031032100,7052,4866,2186,0.690017016,0.309982984
17031040202,17031040202,7249,4201,3048,0.579528211,0.420471789
17031040300,17031040300,3069,1984,1085,0.646464646,0.353535354
17031040600,17031040600,2434,2034,400,0.835661463,0.164338537
17031050200,17031050200,4837,4040,797,0.835228447,0.164771553
17031050300,17031050300,2365,1982,383,0.838054968,0.161945032
17031050600,17031050600,2071,1850,221,0.893288267,0.106711733
17031050900,17031050900,1391,1167,224,0.838964774,0.161035226
17031051000,17031051000,1503,1289,214,0.857618097,0.142381903
17031051100,17031051100,1556,1367,189,0.878534704,0.121465296
17031060300,17031060300,2839,2509,330,0.883761888,0.116238112
17031060400,17031060400,3370,3036,334,0.900890208,0.099109792
17031060900,17031060900,6867,5421,1446,0.789427698,0.210572302
17031061902,17031061902,4240,3616,624,0.852830189,0.147169811
17031062400,17031062400,1421,1306,115,0.919071077,0.080928923
17031062800,17031062800,3506,3188,318,0.909298346,0.090701654
17031063100,17031063100,2173,1883,290,0.866543948,0.133456052
17031063400,17031063400,2180,1874,306,0.859633028,0.140366972
17031070101,17031070101,3796,3321,475,0.874868282,0.125131718
17031070300,17031070300,3367,3025,342,0.898425898,0.101574102
17031070700,17031070700,3481,2766,715,0.794599253,0.205400747
17031071000,17031071000,4442,3809,633,0.857496623,0.142503377
17031071300,17031071300,3513,3148,365,0.896100199,0.103899801
17031071600,17031071600,1783,1543,240,0.865395401,0.134604599
17031071700,17031071700,1652,1330,322,0.805084746,0.194915254
17031080201,17031080201,3287,2941,346,0.894736842,0.105263158
17031080400,17031080400,4317,1545,2772,0.357887422,0.642112578
17031081600,17031081600,3545,2811,734,0.792947814,0.207052186
17031100300,17031100300,6177,5704,473,0.923425611,0.076574389
17031110100,17031110100,5254,4294,960,0.817282071,0.182717929
17031110400,17031110400,4352,3504,848,0.805147059,0.194852941
17031140100,17031140100,3729,1808,1921,0.484848485,0.515151515
17031140200,17031140200,5965,3086,2879,0.517351215,0.482648785
17031140601,17031140601,2786,1353,1433,0.485642498,0.514357502
17031140602,17031140602,5397,2405,2992,0.445617936,0.554382064
17031140701,17031140701,2933,1421,1512,0.484486874,0.515513126
17031140702,17031140702,6187,2872,3315,0.464199127,0.535800873
17031150501,17031150501,3648,2973,675,0.814967105,0.185032895
17031160501,17031160501,4188,2060,2128,0.491881566,0.508118434
17031160601,17031160601,3490,2195,1295,0.628939828,0.371060172
17031160602,17031160602,3589,2300,1289,0.640847033,0.359152967
17031160700,17031160700,5893,3351,2542,0.56864076,0.43135924
17031161000,17031161000,1707,1362,345,0.797891037,0.202108963
17031161100,17031161100,1861,1486,375,0.798495433,0.201504567
17031170600,17031170600,2498,2215,283,0.886709367,0.113290633
17031191301,17031191301,5397,2045,3352,0.378914212,0.621085788
17031200300,17031200300,2209,863,1346,0.390674513,0.609325487
17031200401,17031200401,3603,1578,2025,0.43796836,0.56203164
17031200402,17031200402,4396,1542,2854,0.35077343,0.64922657
17031210100,17031210100,4028,2406,1622,0.597318769,0.402681231
17031210602,17031210602,4683,2725,1958,0.58189195,0.41810805
17031210700,17031210700,4309,2648,1661,0.614527733,0.385472267
17031210900,17031210900,3068,1878,1190,0.612125163,0.387874837
17031220500,17031220500,2626,1874,752,0.713632902,0.286367098
17031220601,17031220601,1766,1097,669,0.621177803,0.378822197
17031220901,17031220901,3498,1525,1973,0.435963408,0.564036592
17031220902,17031220902,3371,1598,1773,0.474043311,0.525956689
17031221200,17031221200,2860,1848,1012,0.646153846,0.353846154
17031221300,17031221300,3222,2010,1212,0.623836127,0.376163873
17031221400,17031221400,3020,1855,1165,0.614238411,0.385761589
17031221500,17031221500,2829,1827,1002,0.645811241,0.354188759
17031221600,17031221600,2969,2433,536,0.819467834,0.180532166
17031222200,17031222200,1912,1622,290,0.84832636,0.15167364
17031222500,17031222500,1410,720,690,0.510638298,0.489361702
17031222600,17031222600,1602,906,696,0.565543071,0.434456929
17031222800,17031222800,1074,415,659,0.386405959,0.613594041
17031222900,17031222900,1244,504,740,0.405144695,0.594855305
17031230100,17031230100,1623,734,889,0.452248922,0.547751078
17031230300,17031230300,1024,397,627,0.387695313,0.612304688
17031230500,17031230500,3570,1267,2303,0.354901961,0.645098039
17031230800,17031230800,1314,590,724,0.449010654,0.550989346
17031240200,17031240200,1452,1212,240,0.834710744,0.165289256
17031240500,17031240500,2251,1937,314,0.860506442,0.139493558
17031240600,17031240600,1457,1027,430,0.704873027,0.295126973
17031240700,17031240700,1535,786,749,0.512052117,0.487947883
17031240900,17031240900,1182,539,643,0.456006768,0.543993232
17031241000,17031241000,2047,934,1113,0.456277479,0.543722521
17031241100,17031241100,3682,1999,1683,0.542911461,0.457088539
17031241200,17031241200,1696,1214,482,0.715801887,0.284198113
17031241400,17031241400,4595,3699,896,0.805005441,0.194994559
17031241600,17031241600,3477,2466,1011,0.709232097,0.290767903
17031242000,17031242000,4565,2659,1906,0.582475356,0.417524644
17031242100,17031242100,3648,2751,897,0.754111842,0.245888158
17031242300,17031242300,3240,2802,438,0.864814815,0.135185185
17031242400,17031242400,2764,2488,276,0.900144718,0.099855282
17031242500,17031242500,3438,2473,965,0.719313554,0.280686446
17031242600,17031242600,5831,3519,2312,0.603498542,0.396501458
17031242700,17031242700,2029,826,1203,0.407097092,0.592902908
17031242900,17031242900,1670,1343,327,0.804191617,0.195808383
17031243300,17031243300,2386,1831,555,0.767393127,0.232606873
17031243400,17031243400,3001,1849,1152,0.616127957,0.383872043
17031243500,17031243500,2937,2137,800,0.727613211,0.272386789
17031250200,17031250200,2669,529,2140,0.198201574,0.801798426
17031250700,17031250700,6098,197,5901,0.032305674,0.967694326
17031250800,17031250800,2488,110,2378,0.044212219,0.955787781
17031251100,17031251100,4302,82,4220,0.019060902,0.980939098
17031251600,17031251600,3649,53,3596,0.014524527,0.985475473
17031251700,17031251700,1495,56,1439,0.037458194,0.962541806
17031252000,17031252000,5719,102,5617,0.017835286,0.982164714
17031252101,17031252101,1370,29,1341,0.021167883,0.978832117
17031252201,17031252201,2953,71,2882,0.024043346,0.975956654
17031252202,17031252202,4609,31,4578,0.006725971,0.993274029
17031260100,17031260100,1248,21,1227,0.016826923,0.983173077
17031260200,17031260200,1136,22,1114,0.019366197,0.980633803
17031260300,17031260300,1564,14,1550,0.008951407,0.991048593
17031260500,17031260500,1934,11,1923,0.005687694,0.994312306
17031260600,17031260600,2478,26,2452,0.010492333,0.989507667
17031260700,17031260700,2032,16,2016,0.007874016,0.992125984
17031260800,17031260800,2539,56,2483,0.022055928,0.977944072
17031270500,17031270500,1689,21,1668,0.012433393,0.987566607
17031271400,17031271400,1527,42,1485,0.027504912,0.972495088
17031280800,17031280800,755,29,726,0.038410596,0.961589404
17031280900,17031280900,942,57,885,0.060509554,0.939490446
17031281900,17031281900,4844,2691,2153,0.555532618,0.444467382
17031282700,17031282700,2349,632,1717,0.26905066,0.73094934
17031283100,17031283100,2703,973,1730,0.359970403,0.640029597
17031283200,17031283200,1664,744,920,0.447115385,0.552884615
17031283800,17031283800,3688,1222,2466,0.331344902,0.668655098
17031290900,17031290900,4530,85,4445,0.018763797,0.981236203
17031291600,17031291600,1055,327,728,0.309952607,0.690047393
17031292400,17031292400,2268,40,2228,0.017636684,0.982363316
17031292500,17031292500,4140,37,4103,0.008937198,0.991062802
17031300500,17031300500,3257,1203,2054,0.369358305,0.630641695
17031300600,17031300600,3212,1215,1997,0.378268991,0.621731009
17031300800,17031300800,4610,1756,2854,0.380911063,0.619088937
17031301100,17031301100,2617,1165,1452,0.445166221,0.554833779
17031301702,17031301702,4045,2113,1932,0.5223733,0.4776267
17031301803,17031301803,5357,2653,2704,0.495239873,0.504760127
17031310200,17031310200,1336,782,554,0.585329341,0.414670659
17031310300,17031310300,1697,830,867,0.489098409,0.510901591
17031310400,17031310400,1332,668,664,0.501501502,0.498498498
17031310600,17031310600,5868,2695,3173,0.45927062,0.54072938
17031310700,17031310700,1692,805,887,0.475768322,0.524231678
17031310800,17031310800,4516,2018,2498,0.446855624,0.553144376
17031310900,17031310900,5123,2200,2923,0.429435877,0.570564123
17031320600,17031320600,4256,2633,1623,0.618656015,0.381343985
17031330100,17031330100,16735,9110,7625,0.544368091,0.455631909
17031330200,17031330200,3806,1652,2154,0.434051498,0.565948502
17031340500,17031340500,1544,773,771,0.500647668,0.499352332
17031340600,17031340600,907,1,906,0.001102536,0.998897464
17031351000,17031351000,3267,146,3121,0.044689317,0.955310683
17031360200,17031360200,1443,13,1430,0.009009009,0.990990991
17031380100,17031380100,1924,64,1860,0.033264033,0.966735967
17031380200,17031380200,1680,22,1658,0.013095238,0.986904762
17031380500,17031380500,752,3,749,0.003989362,0.996010638
17031380700,17031380700,1243,29,1214,0.023330652,0.976669348
17031381200,17031381200,2167,23,2144,0.010613752,0.989386248
17031381400,17031381400,1612,11,1601,0.006823821,0.993176179
17031381500,17031381500,237,8,229,0.033755274,0.966244726
17031381800,17031381800,1188,33,1155,0.027777778,0.972222222
17031381900,17031381900,1295,62,1233,0.047876448,0.952123552
17031390200,17031390200,1840,149,1691,0.080978261,0.919021739
17031390300,17031390300,2743,77,2666,0.028071455,0.971928545
17031390400,17031390400,2934,159,2775,0.054192229,0.945807771
17031390500,17031390500,1598,366,1232,0.229036295,0.770963705
17031390700,17031390700,5592,1480,4112,0.264663805,0.735336195
17031400400,17031400400,1955,11,1944,0.005626598,0.994373402
17031400500,17031400500,2258,12,2246,0.005314438,0.994685562
17031400800,17031400800,2701,9,2692,0.003332099,0.996667901
17031410100,17031410100,1802,544,1258,0.301886792,0.698113208
17031411200,17031411200,1640,1142,498,0.696341463,0.303658537
17031420100,17031420100,1441,38,1403,0.026370576,0.973629424
17031420200,17031420200,1723,292,1431,0.169471851,0.830528149
17031420500,17031420500,2624,32,2592,0.012195122,0.987804878
17031420600,17031420600,2219,22,2197,0.009914376,0.990085624
17031420700,17031420700,3261,18,3243,0.005519779,0.994480221
17031420800,17031420800,2213,51,2162,0.023045639,0.976954361
17031421200,17031421200,1380,3,1377,0.002173913,0.997826087
17031430101,17031430101,3689,36,3653,0.009758742,0.990241258
17031430102,17031430102,2963,49,2914,0.016537293,0.983462707
17031430200,17031430200,4680,103,4577,0.022008547,0.977991453
17031430400,17031430400,2892,28,2864,0.009681881,0.990318119
17031430500,17031430500,3604,27,3577,0.007491676,0.992508324
17031430600,17031430600,1665,39,1626,0.023423423,0.976576577
17031430900,17031430900,1814,9,1805,0.004961411,0.995038589
17031431200,17031431200,3078,33,3045,0.010721248,0.989278752
17031431301,17031431301,3545,55,3490,0.01551481,0.98448519
17031431302,17031431302,4166,54,4112,0.012962074,0.987037926
17031431400,17031431400,6418,164,6254,0.025553132,0.974446868
17031440201,17031440201,5060,13,5047,0.00256917,0.99743083
17031440202,17031440202,2999,12,2987,0.004001334,0.995998666
17031440700,17031440700,1545,10,1535,0.006472492,0.993527508
17031440800,17031440800,1800,8,1792,0.004444444,0.995555556
17031440900,17031440900,2610,7,2603,0.002681992,0.997318008
17031460302,17031460302,3803,130,3673,0.034183539,0.965816461
17031460400,17031460400,3705,57,3648,0.015384615,0.984615385
17031460700,17031460700,3314,742,2572,0.223898612,0.776101388
17031470100,17031470100,2916,20,2896,0.006858711,0.993141289
17031480200,17031480200,1229,6,1223,0.004882018,0.995117982
17031490300,17031490300,2033,9,2024,0.004426955,0.995573045
17031490400,17031490400,1059,4,1055,0.003777148,0.996222852
17031490500,17031490500,2242,37,2205,0.016503122,0.983496878
17031490800,17031490800,4007,30,3977,0.007486898,0.992513102
17031490902,17031490902,5086,14,5072,0.002752654,0.997247346
17031491000,17031491000,5247,19,5228,0.003621117,0.996378883
17031491100,17031491100,4514,35,4479,0.007753655,0.992246345
17031491200,17031491200,2444,20,2424,0.008183306,0.991816694
17031500100,17031500100,3644,24,3620,0.006586169,0.993413831
17031500200,17031500200,2015,19,1996,0.00942928,0.99057072
17031500300,17031500300,1666,743,923,0.445978391,0.554021609
17031510300,17031510300,5360,35,5325,0.006529851,0.993470149
17031520200,17031520200,3817,1468,2349,0.384595232,0.615404768
17031530100,17031530100,2371,457,1914,0.192745677,0.807254323
17031530200,17031530200,5152,20,5132,0.003881988,0.996118012
17031530400,17031530400,2223,24,2199,0.010796221,0.989203779
17031530501,17031530501,5402,26,5376,0.004813032,0.995186968
17031530502,17031530502,1667,5,1662,0.0029994,0.9970006
17031530503,17031530503,5345,25,5320,0.004677268,0.995322732
17031530600,17031530600,3207,30,3177,0.009354537,0.990645463
17031540101,17031540101,3373,59,3314,0.017491847,0.982508153
17031570100,17031570100,1257,700,557,0.556881464,0.443118536
17031580100,17031580100,2989,1479,1510,0.494814319,0.505185681
17031580300,17031580300,2426,1062,1364,0.437757626,0.562242374
17031580800,17031580800,2061,913,1148,0.44298884,0.55701116
17031590500,17031590500,1672,806,866,0.482057416,0.517942584
17031610300,17031610300,5658,2214,3444,0.391304348,0.608695652
17031611100,17031611100,2922,907,2015,0.310403833,0.689596167
17031611300,17031611300,3556,1390,2166,0.390888639,0.609111361
17031611400,17031611400,4105,1612,2493,0.392691839,0.607308161
17031611500,17031611500,3567,1309,2258,0.366975049,0.633024951
17031612000,17031612000,1545,29,1516,0.018770227,0.981229773
17031612100,17031612100,1470,39,1431,0.026530612,0.973469388
17031630100,17031630100,1156,386,770,0.333910035,0.666089965
17031630400,17031630400,7083,3347,3736,0.472539884,0.527460116
17031640100,17031640100,1211,775,436,0.639966969,0.360033031
17031660301,17031660301,1785,386,1399,0.216246499,0.783753501
17031660800,17031660800,5865,838,5027,0.1428815,0.8571185
17031661000,17031661000,5706,266,5440,0.046617596,0.953382404
17031670100,17031670100,1516,12,1504,0.007915567,0.992084433
17031670200,17031670200,1380,8,1372,0.005797101,0.994202899
17031670300,17031670300,1411,34,1377,0.024096386,0.975903614
17031670400,17031670400,1956,26,1930,0.013292434,0.986707566
17031670700,17031670700,1491,10,1481,0.006706908,0.993293092
17031671100,17031671100,1259,12,1247,0.009531374,0.990468626
17031671400,17031671400,2072,31,2041,0.01496139,0.98503861
17031671500,17031671500,3221,25,3196,0.007761565,0.992238435
17031671600,17031671600,2495,11,2484,0.004408818,0.995591182
17031671800,17031671800,1422,10,1412,0.007032349,0.992967651
17031671900,17031671900,1378,3,1375,0.002177068,0.997822932
17031672000,17031672000,3735,24,3711,0.006425703,0.993574297
17031680600,17031680600,1431,11,1420,0.007686932,0.992313068
17031681100,17031681100,3517,11,3506,0.003127666,0.996872334
17031681200,17031681200,2716,11,2705,0.004050074,0.995949926
17031681300,17031681300,2936,4,2932,0.001362398,0.998637602
17031690300,17031690300,2191,20,2171,0.009128252,0.990871748
17031690900,17031690900,4520,12,4508,0.002654867,0.997345133
17031691200,17031691200,2847,13,2834,0.00456621,0.99543379
17031691300,17031691300,2448,22,2426,0.008986928,0.991013072
17031691400,17031691400,3611,45,3566,0.012461922,0.987538078
17031691500,17031691500,1930,25,1905,0.012953368,0.987046632
17031700100,17031700100,3427,547,2880,0.159614823,0.840385177
17031700402,17031700402,3914,824,3090,0.210526316,0.789473684
17031710100,17031710100,1275,15,1260,0.011764706,0.988235294
17031710200,17031710200,5049,18,5031,0.003565062,0.996434938
17031710500,17031710500,4123,10,4113,0.002425418,0.997574582
17031710600,17031710600,1838,2,1836,0.001088139,0.998911861
17031710700,17031710700,3583,11,3572,0.003070053,0.996929947
17031710900,17031710900,2198,13,2185,0.005914468,0.994085532
17031711000,17031711000,3475,16,3459,0.004604317,0.995395683
17031711100,17031711100,2835,11,2824,0.003880071,0.996119929
17031711200,17031711200,5145,12,5133,0.002332362,0.997667638
17031711300,17031711300,1626,13,1613,0.00799508,0.99200492
17031711400,17031711400,2654,11,2643,0.004144687,0.995855313
17031711500,17031711500,2539,13,2526,0.005120126,0.994879874
17031730201,17031730201,5941,14,5927,0.002356506,0.997643494
17031730202,17031730202,3115,16,3099,0.005136437,0.994863563
17031730300,17031730300,1166,5,1161,0.004288165,0.995711835
17031730400,17031730400,3514,38,3476,0.010813887,0.989186113
17031730500,17031730500,4388,22,4366,0.005013674,0.994986326
17031730600,17031730600,3614,36,3578,0.009961262,0.990038738
17031740300,17031740300,4713,4516,197,0.958200721,0.041799279
17031750500,17031750500,5936,1160,4776,0.19541779,0.80458221
17031750600,17031750600,3681,25,3656,0.006791633,0.993208367
17031770800,17031770800,5582,4459,1123,0.798817628,0.201182372
17031800500,17031800500,4901,4636,265,0.945929402,0.054070598
17031800600,17031800600,2400,2343,57,0.97625,0.02375
17031800900,17031800900,4416,2938,1478,0.665307971,0.334692029
17031801601,17031801601,4234,3670,564,0.866792631,0.133207369
17031801702,17031801702,4671,4163,508,0.891243845,0.108756155
17031801901,17031801901,4369,3634,735,0.831769284,0.168230716
17031802004,17031802004,5381,3324,2057,0.617729047,0.382270953
17031802200,17031802200,4410,4120,290,0.934240363,0.065759637
17031802605,17031802605,6799,5670,1129,0.833946169,0.166053831
17031805402,17031805402,5095,4334,761,0.85063788,0.14936212
17031805502,17031805502,3888,3719,169,0.956532922,0.043467078
17031805902,17031805902,6449,5409,1040,0.838734688,0.161265312
17031806004,17031806004,7604,4829,2775,0.635060494,0.364939506
17031806201,17031806201,4196,3248,948,0.774070543,0.225929457
17031806202,17031806202,4550,4000,550,0.879120879,0.120879121
17031806801,17031806801,4225,2738,1487,0.648047337,0.351952663
17031807000,17031807000,5736,3086,2650,0.538005579,0.461994421
17031807200,17031807200,5912,3391,2521,0.573579161,0.426420839
17031807300,17031807300,7191,3978,3213,0.553191489,0.446808511
17031807600,17031807600,6540,3418,3122,0.522629969,0.477370031
17031808200,17031808200,5196,3674,1522,0.707082371,0.292917629
17031808600,17031808600,2015,1856,159,0.921091811,0.078908189
17031808702,17031808702,5504,3677,1827,0.668059593,0.331940407
17031808900,17031808900,4101,3694,407,0.900755913,0.099244087
17031809000,17031809000,3976,3674,302,0.924044266,0.075955734
17031809600,17031809600,3301,1295,2006,0.392305362,0.607694638
17031809800,17031809800,2717,2125,592,0.782112624,0.217887376
17031810100,17031810100,4253,2895,1358,0.680695979,0.319304021
17031810502,17031810502,5164,4623,541,0.895236251,0.104763749
17031811200,17031811200,5270,4532,738,0.859962049,0.140037951
17031811702,17031811702,5124,3419,1705,0.667252147,0.332747853
17031811800,17031811800,5399,3926,1473,0.727171698,0.272828302
17031812801,17031812801,2943,1764,1179,0.599388379,0.400611621
17031812802,17031812802,2444,1722,722,0.704582651,0.295417349
17031813200,17031813200,4251,3114,1137,0.732533522,0.267466478
17031813302,17031813302,3934,1768,2166,0.449415353,0.550584647
17031813802,17031813802,5130,2592,2538,0.505263158,0.494736842
17031813900,17031813900,6329,3206,3123,0.506557118,0.493442882
17031814300,17031814300,4884,2707,2177,0.554258804,0.445741196
17031814500,17031814500,4978,3073,1905,0.617316191,0.382683809
17031814600,17031814600,5723,3187,2536,0.556875764,0.443124236
17031814800,17031814800,6466,3970,2496,0.613980823,0.386019177
17031814900,17031814900,6181,3097,3084,0.50105161,0.49894839
17031817300,17031817300,2653,171,2482,0.064455334,0.935544666
17031818100,17031818100,2318,1727,591,0.745038827,0.254961173
17031818600,17031818600,4715,4088,627,0.867020148,0.132979852
17031818700,17031818700,3625,3264,361,0.900413793,0.099586207
17031818800,17031818800,5556,5093,463,0.916666667,0.083333333
17031819200,17031819200,6107,4669,1438,0.764532504,0.235467496
17031819900,17031819900,3398,3298,100,0.970570924,0.029429076
17031820300,17031820300,5353,3559,1794,0.664860826,0.335139174
17031820606,17031820606,3650,3226,424,0.883835616,0.116164384
17031821001,17031821001,5233,4469,764,0.85400344,0.14599656
17031821401,17031821401,3338,262,3076,0.078490114,0.921509886
17031821402,17031821402,3587,116,3471,0.032339002,0.967660998
17031821500,17031821500,2341,66,2275,0.02819308,0.97180692
17031822000,17031822000,4349,3986,363,0.916532536,0.083467464
17031823002,17031823002,6077,5216,861,0.858318249,0.141681751
17031823603,17031823603,2702,783,1919,0.289785344,0.710214656
17031823604,17031823604,3578,3399,179,0.949972051,0.050027949
17031823702,17031823702,6650,5362,1288,0.806315789,0.193684211
17031823704,17031823704,4020,3666,354,0.911940299,0.088059701
17031823805,17031823805,2953,2764,189,0.935997291,0.064002709
17031823806,17031823806,3716,3290,426,0.885360603,0.114639397
17031824106,17031824106,7063,6418,645,0.908679032,0.091320968
17031824116,17031824116,4718,4200,518,0.890207715,0.109792285
17031824123,17031824123,7756,7021,735,0.905234657,0.094765343
17031825000,17031825000,5103,3763,1340,0.737409367,0.262590633
17031825303,17031825303,3872,3440,432,0.888429752,0.111570248
17031825505,17031825505,5525,589,4936,0.106606335,0.893393665
17031825801,17031825801,3550,304,3246,0.085633803,0.914366197
17031826000,17031826000,3334,714,2620,0.214157169,0.785842831
17031826402,17031826402,5132,333,4799,0.064886984,0.935113016
17031826500,17031826500,5936,416,5520,0.070080863,0.929919137
17031826700,17031826700,5569,213,5356,0.038247441,0.961752559
17031826902,17031826902,1643,21,1622,0.012781497,0.987218503
17031827000,17031827000,3624,144,3480,0.039735099,0.960264901
17031827300,17031827300,2947,166,2781,0.05632847,0.94367153
17031827400,17031827400,4298,166,4132,0.038622615,0.961377385
17031827600,17031827600,3463,31,3432,0.008951776,0.991048224
17031827700,17031827700,2902,476,2426,0.16402481,0.83597519
17031827805,17031827805,2866,587,2279,0.204815073,0.795184927
17031830700,17031830700,4247,2118,2129,0.498704968,0.501295032
17031830800,17031830800,2391,1852,539,0.774571309,0.225428691
17031830900,17031830900,2877,1940,937,0.674313521,0.325686479
17031831000,17031831000,2138,1821,317,0.851730589,0.148269411
17031831200,17031831200,5021,1933,3088,0.384983071,0.615016929
17031831600,17031831600,7270,4148,3122,0.570563961,0.429436039
17031831800,17031831800,6322,3529,2793,0.558209427,0.441790573
17031832200,17031832200,2940,2559,381,0.870408163,0.129591837
17031832300,17031832300,1870,1520,350,0.812834225,0.187165775
17031832400,17031832400,3181,2177,1004,0.684375982,0.315624018
17031833000,17031833000,2768,2113,655,0.763367052,0.236632948
17031833300,17031833300,2278,1362,916,0.597892888,0.402107112
17031834000,17031834000,3632,18,3614,0.004955947,0.995044053
17031834300,17031834300,6570,75,6495,0.011415525,0.988584475
17031834500,17031834500,1475,9,1466,0.006101695,0.993898305
17031834700,17031834700,2078,18,2060,0.008662175,0.991337825
17031834900,17031834900,2272,18,2254,0.007922535,0.992077465
17031835500,17031835500,1677,52,1625,0.031007752,0.968992248
17031835600,17031835600,1199,14,1185,0.011676397,0.988323603
17031835800,17031835800,1576,42,1534,0.026649746,0.973350254
17031835900,17031835900,3271,53,3218,0.016202996,0.983797004
17031836100,17031836100,1761,46,1715,0.026121522,0.973878478
17031836300,17031836300,1288,336,952,0.260869565,0.739130435
17031836400,17031836400,2979,99,2880,0.033232628,0.966767372
17031836500,17031836500,1496,27,1469,0.018048128,0.981951872
17031836600,17031836600,2997,946,2051,0.315648982,0.684351018
17031836700,17031836700,2397,157,2240,0.06549854,0.93450146
17031836900,17031836900,1442,109,1333,0.075589459,0.924410541
17031837000,17031837000,2085,99,1986,0.047482014,0.952517986
17031837100,17031837100,1819,188,1631,0.103353491,0.896646509
17031837300,17031837300,2483,150,2333,0.060410793,0.939589207
17031837400,17031837400,2279,186,2093,0.081614743,0.918385257
17031837800,17031837800,2796,402,2394,0.143776824,0.856223176
17031838100,17031838100,1713,412,1301,0.240513719,0.759486281
17031838200,17031838200,1578,729,849,0.461977186,0.538022814
17031838800,17031838800,3233,685,2548,0.211877513,0.788122487
17031839500,17031839500,1545,171,1374,0.110679612,0.889320388
17031839600,17031839600,1952,90,1862,0.046106557,0.953893443
17031840200,17031840200,2338,651,1687,0.278443114,0.721556886
17031840400,17031840400,3326,1269,2057,0.381539387,0.618460613
17031841000,17031841000,849,213,636,0.250883392,0.749116608
17031841200,17031841200,5262,2340,2922,0.444697834,0.555302166
17031841300,17031841300,4463,2383,2080,0.533945776,0.466054224
17031841500,17031841500,2962,50,2912,0.016880486,0.983119514
17031841600,17031841600,1166,52,1114,0.044596913,0.955403087
17031842100,17031842100,6731,1239,5492,0.184073689,0.815926311
17031842300,17031842300,3244,2281,963,0.703144266,0.296855734
17031842500,17031842500,2451,7,2444,0.002855977,0.997144023
17031843000,17031843000,2378,7,2371,0.00294365,0.99705635
17031843300,17031843300,1228,190,1038,0.154723127,0.845276873
17031843400,17031843400,1451,78,1373,0.05375603,0.94624397
17031843600,17031843600,2807,65,2742,0.023156395,0.976843605
17097864505,17097864505,6493,4929,1564,0.759125212,0.240874788
17097864700,17097864700,2976,2798,178,0.940188172,0.059811828
18089010302,18089010302,3472,79,3393,0.022753456,0.977246544
18089020100,18089020100,4750,3768,982,0.793263158,0.206736842
18089020200,18089020200,2513,2083,430,0.828889773,0.171110227
18089020400,18089020400,5554,3375,2179,0.607670148,0.392329852
18089020500,18089020500,3984,1952,2032,0.489959839,0.510040161
18089020600,18089020600,2255,849,1406,0.376496674,0.623503326
18089020700,18089020700,5183,1875,3308,0.361759599,0.638240401
18089020800,18089020800,4455,660,3795,0.148148148,0.851851852
18089020900,18089020900,4375,2475,1900,0.565714286,0.434285714
18089021000,18089021000,5183,3519,1664,0.678950415,0.321049585
18089021100,18089021100,3016,2266,750,0.75132626,0.24867374
18089021300,18089021300,3630,2279,1351,0.627823691,0.372176309
18089021400,18089021400,5175,2688,2487,0.51942029,0.48057971
18089021600,18089021600,2996,2083,913,0.695260347,0.304739653
18089021700,18089021700,4913,3144,1769,0.639934867,0.360065133
18089021800,18089021800,3696,2202,1494,0.595779221,0.404220779
18089021900,18089021900,5184,3572,1612,0.68904321,0.31095679
18089022000,18089022000,5082,2945,2137,0.579496261,0.420503739
18089030200,18089030200,1436,325,1111,0.22632312,0.77367688
18089030400,18089030400,3505,1813,1692,0.517261056,0.482738944
18089030500,18089030500,4201,2046,2155,0.487026898,0.512973102
18089030600,18089030600,5052,2738,2314,0.541963579,0.458036421
18089040200,18089040200,3523,2663,860,0.755889867,0.244110133
18089040300,18089040300,7895,6705,1190,0.849271691,0.150728309
18089040401,18089040401,5208,4688,520,0.90015361,0.09984639
18089040600,18089040600,3759,3379,380,0.898909284,0.101090716
18089040700,18089040700,5031,4511,520,0.896640827,0.103359173
18089041001,18089041001,5525,2587,2938,0.468235294,0.531764706
18089041100,18089041100,2377,1993,384,0.83845183,0.16154817
18089041200,18089041200,2474,1956,518,0.790622474,0.209377526
18089010304,18089010304,3149,278,2871,0.088281994,0.911718006
18089020300,18089020300,6601,4690,1911,0.710498409,0.289501591
18089021500,18089021500,2285,1559,726,0.682275711,0.317724289
18089030100,18089030100,1456,24,1432,0.016483516,0.983516484
18089030300,18089030300,2577,230,2347,0.089251067,0.910748933
18089030700,18089030700,2064,534,1530,0.25872093,0.74127907
18089030800,18089030800,4272,1513,2759,0.354166667,0.645833333
18089030900,18089030900,3575,1097,2478,0.306853147,0.693146853
18089031000,18089031000,1560,210,1350,0.134615385,0.865384615
18089040100,18089040100,1474,1148,326,0.778833107,0.221166893
